2
########
#S.....#
######.#
##X###.#
##.#...#
#......#
########

########
#.....S#
###.####
#...#..#
#.##...#
#.#..#.#
#....#X#
########